+S#######+++++++++++++++++++
++++++++#++###++++#+++++++++
++++++++#++#+#++++#+++++++++
++++++++#++#+#+#++#+++++++++
++++++++####+###++#+++++++++
++++++++++++++#####+++++++++
++++++++++++++++++#+++++++++
++++++++++++++++++#+++++++++
++++++++++++++++++#++++++++
++++++++++++++++++#+++######
++++++++++++++++++#+++#++++#
++++++++++++++++++#+++#++++#
++++++++++++++++++######+++#
++++++++++++++++++++++#++###
++++++++++++++++++++++#++#++
++++++++++++++++++++++####++
++++++++++++++++++++++#+###Z
++++++++++++++++++++++#+++++